
NO ./assets/wall_no.xpm
SO ./assets/wall_so.xpm
WE ./assets/wall_we.xpm
EA ./assets/wall_ea.xpm

F 119,121,30
C 121,110,109

1111111111111111111111111111111111111
110000000000000000000000000000001001111
110000000000000011111111111111111111111
11000000000000000000000000000111001111
1100000000000000S000000000001000011111
11000000000000000000000000000111011111
11111111111111111111111111111111111111