               NO                ./path_to_the_north_texture   
SO ./path_to_the_south_texture  
WE ./path_to_the_west_texture
EA ./path_to_the_east_texture

F 220,100,0
C 225,30,0


111111111111111111111111
1000000000110000000000001
1011000001110001000000001
100100001111100W000000001
100000001   110011010100111111111111
100010001     110011100010111
101000001   11000000000011
1100100111111011111011111
1111 1111 1 1111111111111

