               NO                ./path_to_the_north_texture   
SO            ./path_to_the_south_texture  
WE ./path_to_the_west_texture
EA           ./path_to_the_east_texture

F 220,100,0
C     225,233,56


1111111111           111111111                 1111111111111111111
 1000000001         1000000001                10000000011000000001
  1000000001       1000000001                1000000001  1000000001
   1000000001     1000000001                1000000001    1000000001
    1000000001   1000000001                1000000001      1000000001
     1000000001 1000000001                1000000001        1000000001
      1000000001000000001                1000000001          1000000001
       11000000000000001                1000000001            1000000001
        100000000000001                1000000001              1000000001
         1000000000011                1000000001                1000000001
          10000000001                10000000011111111111111111110000000001
          10000000001               1000000001000000000000000000010000000011
          10000000001               1000000001111111111111111111110000000001
          10000000001               1000000001                    1000000001
          10000000001               1000000001                    1000000001
          10000000001               1000000001                    1000000001
          1000E000001               1000000001                    1000000001
          10000000001               1000000001                    1000000001
          10000000001               1000000001                    1000000001
          100000000011111111111111111000000001                    1000000001
          100000000000000000000000000000000001                    1000000001
          111111111111111111111111111111111111                    1111111111